20
18

000 000 000 000 000 000 298 000 000 000 000 000 039 019 019 295 297 000 019 039
000 000 000 000 000 000 298 000 000 000 096 000 000 019 039 295 297 000 039 000
000 260 000 095 000 000 298 000 000 000 000 000 000 039 000 295 297 000 000 000
335 336 336 337 000 000 298 000 000 000 000 000 000 000 000 295 297 000 000 000
000 000 000 000 000 000 298 000 000 000 000 000 000 000 000 315 317 000 000 000
000 000 000 140 141 142 298 000 015 000 000 000 000 000 000 000 030 000 000 000
000 000 000 160 161 162 298 016 035 000 018 054 000 017 037 270 271 272 000 000
140 141 142 000 000 000 298 176 176 176 176 176 176 176 176 311 290 292 000 000
160 161 162 000 000 000 298 000 000 325 000 000 000 000 000 000 290 292 000 000
000 000 000 140 141 142 298 000 000 345 000 000 000 000 000 000 310 312 000 000
000 000 000 160 161 162 298 000 000 000 000 000 000 000 000 000 000 030 000 000
140 141 142 000 000 000 318 000 000 000 000 000 000 000 000 195 196 196 196 197
160 161 162 000 000 000 000 000 000 000 000 000 000 000 000 215 000 000 000 217
000 000 000 000 000 000 000 000 000 000 000 000 000 000 000 215 000 000 000 217
000 000 000 000 000 104 106 000 000 000 000 000 033 000 163 215 000 000 000 217
000 000 000 000 000 000 000 000 000 000 000 000 195 196 196 197 000 000 000 217
186 057 184 000 000 000 000 000 000 185 000 000 215 000 000 217 000 000 000 217
271 271 272 000 000 246 000 000 000 205 000 000 215 000 000 217 000 000 000 217

000 000 000 000 000 000 001 000 000 000 000 000 000 000 000 001 001 000 000 000
000 000 000 000 000 000 001 000 000 000 006 000 000 000 000 001 001 000 000 000
000 010 000 000 000 000 001 000 000 000 000 000 000 000 000 001 001 000 000 000
001 001 001 001 000 000 001 000 000 000 000 000 000 000 000 001 001 000 000 000
000 000 000 000 000 000 001 000 000 000 000 000 000 000 000 001 001 000 000 000
000 000 000 000 000 000 001 000 000 000 000 000 000 000 000 000 011 000 000 000
000 000 000 002 002 002 001 000 000 000 000 000 000 000 000 001 001 001 000 000
000 000 000 000 000 000 001 001 001 001 001 001 001 001 001 001 001 001 000 000
002 002 002 000 000 000 001 000 000 000 000 000 000 000 000 000 001 001 000 000
000 000 000 000 000 000 001 000 000 000 000 000 000 000 000 000 001 001 000 000
000 000 000 002 002 002 001 000 000 000 000 000 000 000 000 000 000 011 000 000
000 000 000 000 000 000 001 000 000 000 000 000 000 000 000 001 001 001 001 001
002 002 002 000 000 000 000 000 000 000 000 000 000 000 000 001 000 000 000 001
000 000 000 000 000 000 000 000 000 000 000 000 000 000 000 001 000 000 000 001
000 000 000 000 000 003 003 000 000 000 000 000 000 000 004 001 000 000 000 001
000 000 000 000 000 000 000 000 000 000 000 000 001 001 001 001 000 000 000 001
000 007 000 000 000 000 000 000 000 000 000 000 001 000 000 001 000 000 000 001
001 001 001 000 000 000 000 000 000 000 000 000 001 000 000 001 000 000 000 001