20
18

000 000 000 000 039 000 000 039 000 019 039 000 000 019 000 039 019 000 039 000
000 000 000 000 000 000 000 000 000 039 000 000 000 019 000 000 039 000 000 000
000 000 000 000 000 000 000 000 000 000 000 000 000 039 000 000 000 000 000 000
000 000 000 000 000 000 014 000 000 000 000 000 000 084 086 000 000 000 000 000
000 000 000 000 000 000 034 000 000 000 000 000 000 000 000 000 000 000 000 000
000 000 000 000 000 115 116 116 117 000 000 087 088 089 000 000 000 094 000 000
000 186 057 184 000 135 000 000 137 000 000 107 108 109 000 000 000 044 046 000
115 176 176 176 176 000 000 000 137 000 000 127 128 129 000 000 000 000 000 000
138 039 000 019 000 155 156 156 157 000 000 187 188 189 000 000 000 000 000 000
138 000 096 039 000 000 000 070 000 000 092 207 208 209 037 000 044 045 046 000
138 000 054 000 000 115 176 176 176 176 176 176 176 176 177 000 000 000 000 000
155 176 176 176 176 157 000 003 000 003 000 043 000 003 000 000 000 000 000 000
000 000 166 000 325 000 000 023 000 006 000 000 000 023 000 000 000 000 000 000
000 000 000 000 345 000 000 023 000 000 000 000 000 005 000 000 000 163 000 000
000 000 000 000 000 000 000 005 000 000 000 000 024 000 026 000 000 201 000 000
000 000 000 186 000 000 024 000 026 000 000 000 044 045 046 000 000 204 000 000
000 260 248 206 000 000 044 045 046 000 185 000 000 000 000 000 000 204 000 000
175 176 176 177 000 000 000 000 000 000 205 000 000 000 246 000 000 221 000 000

000 000 000 000 000 000 000 000 000 000 000 000 000 000 000 000 000 000 000 000
000 000 000 000 000 000 000 000 000 000 000 000 000 000 000 000 000 000 000 000
000 000 000 000 000 000 000 000 000 000 000 000 000 000 000 000 000 000 000 000
000 000 000 000 000 000 000 000 000 000 000 000 000 003 003 000 000 000 000 000
000 000 000 000 000 000 000 000 000 000 000 000 000 000 000 000 000 000 000 000
000 000 000 000 000 001 001 001 001 000 000 000 000 000 000 000 000 000 000 000
000 000 007 000 000 001 000 000 001 000 000 000 000 000 000 000 000 002 002 000
001 001 001 001 001 000 000 000 001 000 000 000 000 000 000 000 000 000 000 000
001 000 000 000 000 001 001 001 001 000 000 000 000 000 000 000 000 000 000 000
001 000 006 000 000 000 000 011 000 000 000 000 000 000 000 000 002 002 002 000
001 000 000 000 000 001 001 001 001 001 001 001 001 001 001 000 000 000 000 000
001 001 001 001 001 001 000 000 000 000 000 000 000 000 000 000 000 000 000 000
000 000 000 000 000 000 000 000 000 000 000 000 000 000 000 000 000 000 000 000
000 000 000 000 000 000 000 000 000 000 000 000 000 000 000 000 000 004 000 000
000 000 000 000 000 000 000 000 000 000 000 000 000 000 000 000 000 001 000 000
000 000 000 000 000 000 000 000 000 000 000 002 002 002 002 000 000 001 000 000
000 010 000 000 000 000 002 002 002 000 000 000 000 000 000 000 000 001 000 000
001 001 001 001 000 000 000 000 000 000 000 000 000 000 000 000 000 001 000 000